6 6 6 6 6 6 6 6 6 6 6 6 6 6 6 6 6 6 6 6 6 6 6 6 6 6 6 6 6 6 6 6 6 6 6 6 6 6 6 6 
6 6 6 6 6 6 6 6 6 6 6 6 6 6 6 6 6 6 6 6 6 6 6 6 6 6 6 6 6 6 6 6 6 6 6 6 6 6 6 6 
6 3 3 3 3 3 3 3 3 3 3 3 3 3 3 3 3 3 5 5 5 5 5 3 3 3 3 3 3 3 3 3 3 3 3 3 3 3 3 6 
6 -1 -1 -1 -1 -1 -1 -1 -1 -1 -1 -1 -1 -1 -1 -1 -1 -1 5 5 -1 -1 5 -1 -1 -1 -1 -1 -1 -1 -1 -1 -1 -1 -1 -1 -1 -1 -1 6 
6 -1 -1 -1 -1 -1 -1 -1 -1 -1 -1 -1 -1 -1 -1 -1 -1 -1 5 5 -1 -1 5 -1 -1 -1 -1 -1 -1 -1 -1 -1 -1 -1 -1 -1 -1 -1 -1 6 
6 -1 -1 -1 -1 -1 -1 -1 -1 -1 -1 -1 -1 -1 -1 -1 -1 -1 8 8 -1 -1 5 -1 -1 -1 5 5 0 5 5 5 5 -1 -1 2 -1 2 -1 6 
6 -1 -1 -1 -1 -1 -1 -1 4 4 0 4 4 4 -1 -1 -1 -1 8 8 -1 -1 5 -1 -1 -1 5 5 5 5 5 5 5 2 -1 -1 -1 2 -1 6 
6 -1 0 -1 -1 2 2 -1 -1 -1 -1 -1 -1 -1 0 -1 -1 -1 8 8 -1 -1 5 0 -1 -1 5 -1 -1 -1 -1 -1 -1 -1 -1 -1 -1 2 0 6 
6 -1 -1 -1 -1 2 2 -1 -1 -1 -1 -1 -1 -1 -1 4 4 4 5 5 -1 -1 5 -1 -1 -1 5 -1 -1 -1 -1 -1 -1 -1 4 4 4 4 4 6 
6 -1 -1 -1 -1 2 2 -1 -1 -1 -1 -1 -1 -1 -1 -1 -1 -1 5 5 -1 -1 5 -1 -1 -1 5 -1 -1 -1 -1 -1 4 4 -1 -1 -1 -1 -1 6 
6 -1 -1 -1 -1 2 2 4 4 4 0 -1 -1 -1 -1 -1 -1 -1 5 5 -1 -1 5 -1 -1 2 5 -1 -1 -1 0 4 -1 -1 -1 -1 -1 -1 -1 6 
6 -1 -1 -1 -1 -1 -1 -1 -1 -1 -1 -1 -1 -1 -1 -1 -1 -1 5 5 -1 -1 5 -1 -1 -1 5 -1 -1 -1 5 -1 -1 -1 -1 -1 -1 -1 -1 6 
6 -1 -1 -1 -1 -1 -1 -1 -1 -1 -1 -1 -1 -1 -1 -1 -1 -1 5 5 -1 -1 5 -1 -1 -1 5 -1 -1 -1 5 -1 -1 -1 -1 -1 -1 -1 -1 6 
6 -1 -1 -1 -1 -1 -1 -1 -1 -1 -1 -1 4 4 0 4 -1 -1 5 5 -1 -1 5 2 -1 -1 5 -1 -1 -1 5 -1 -1 -1 -1 -1 -1 -1 -1 6 
6 -1 -1 -1 -1 -1 -1 -1 -1 -1 -1 -1 -1 -1 -1 -1 -1 -1 5 5 -1 -1 5 -1 -1 -1 5 -1 -1 0 5 -1 -1 -1 -1 -1 -1 -1 -1 6 
6 -1 -1 -1 -1 -1 -1 -1 2 2 -1 -1 -1 -1 -1 -1 -1 -1 5 5 -1 -1 5 -1 -1 2 5 -1 -1 -1 5 5 5 5 5 5 5 5 5 6 
6 -1 -1 -1 -1 -1 -1 -1 2 2 -1 -1 -1 -1 -1 -1 -1 -1 5 5 -1 -1 -1 -1 -1 -1 5 -1 -1 -1 -1 -1 -1 8 8 8 8 -1 -1 6 
6 -1 -1 -1 -1 -1 -1 -1 2 2 -1 -1 -1 -1 -1 -1 -1 -1 5 5 -1 -1 -1 -1 -1 -1 5 -1 -1 -1 -1 -1 -1 8 8 8 8 -1 -1 6 
6 1 1 1 1 1 0 1 1 1 1 1 1 1 1 1 1 1 5 5 5 5 5 5 5 5 5 0 1 1 1 1 1 1 1 1 1 7 7 6 
6 6 6 6 6 6 6 6 6 6 6 6 6 6 6 6 6 6 6 6 6 6 6 6 6 6 6 6 6 6 6 6 6 6 6 6 6 6 6 6 
6 6 6 6 6 6 6 6 6 6 6 6 6 6 6 6 6 6 6 6 6 6 6 6 6 6 6 6 6 6 6 6 6 6 6 6 6 6 6 6 
6 6 6 6 6 6 6 6 6 6 6 6 6 6 6 6 6 6 6 6 6 6 6 6 6 6 6 6 6 6 6 6 6 6 6 6 6 6 6 6 
